0 0 0 0 0 0 0 0 0 0 0
0 0 0 0 0 0 0 0 0 0 0
0 3 3 3 3 0 3 3 3 3 0
0 3 2 2 3 0 3 2 2 3 0
0 2 1 1 2 0 2 1 1 2 0
0 2 1 1 2 0 2 1 1 2 0
0 3 2 2 3 0 3 2 2 3 0
0 3 3 3 3 0 3 3 3 3 0
0 9 9 9 9 0 9 9 9 9 0
0 3 3 3 3 0 3 3 3 3 0
0 3 2 2 3 0 3 2 2 3 0
0 2 1 1 2 0 2 1 1 2 0
0 2 1 1 2 0 2 1 1 2 0
0 3 2 2 3 0 3 2 2 3 0
0 3 3 3 3 0 3 3 3 3 0
0 0 0 0 0 0 0 0 0 0 0
0 0 0 0 0 0 0 0 0 0 0
0 0 0 0 0 0 0 0 0 0 0
